25
25
WWWWWWWWWWWWWWWWWWWWWWWWW
WEEWEEEEEEEEEEEEEEEEWEEEW
WEEWEEWWEEEWWEEEEEEEWEEEW
WEEWEEWWEEEWEEEEWWEEWEEEW
WEWWEEEEEEEWEEEEEEEEWEEEW
WEEEEEEEEEEEEEEEEEEEWWEEW
WEEEEEEEWEEEEWWWWEEEEEEWW
WEEEEEEEWWWEEWEEWEWEEEEWW
WEEEWEEEEEWEEWEEWEWEEEEWW
WEEEWEEEEEWEEWEEWEWWEEEWW
WEEEWEEEEEWEEWEEWEEWWWWWW
WEEEWWWWWEWEEEEEEEEEEEEEW
WEEEEEEEEEWEEEEEEEEEEEEEW
WEEEEEEEEEWEEEEWEEWWWWEEW
WEEEEEEEEEWWWWEWEEWEEWEEW
WEEEEEWWEEEEEEEWWWWEEWEEW
WEEEEEWWEEEEEEEEEEEEEEEEW
WWWWWEEEEEEEWEEEEEEEEEEEW
WEEEWEEEEEEEWEEEEEEEEEEEW
WEEEWEEEEEEEWWWWWEEWWWWWW
WEEEWEEEWWWWWEEEEEEWEEEEW
WEEEWEEEEEEEWEEEEEEWEEEEW
WEEEWEEEEEEEWEEEEEEWEEEEW
WEEEEEEEEEEEEEEEEEEEEEEEW
WWWWWWWWWWWWWWWWWWWWWWWWW